###############################################################
#.............................................................#
#.............................................................#
#.............................................................#
#.............................................................#
#.............................................................#
#.............................................................#
#.............................................................#
#.............................................................#
#.............................................................#
#.............................................................#
#.............................................................#
#.............................................................#
#.............................................................#
#.............................................................#
#.............................................................#
#.............................................................#
#.............................................................#
#.............................................................#
#.............................................................#
#.............................................................#
#.............................................................#
#.............................................................#
#.............................................................#
#.............................................................#
#.............................................................#
#.............................................................#
#.............................................................#
#.............................................................#
#.............................................................#
#.............................................................#
#.............................................................#
#..............................############...................#
#.............................................................#
###############################################################