#############################################################################################################################
#...........................................................................................................................#
#...........................................................................................................................#
#...........................................................................................................................#
#...........................................................................................................................#
#...........................................................................................................................#
#...........................................................................................................................#
#...........................................................................................................................#
#...........................................................................................................................#
#...........................................................................................................................#
#...........................................................................................................................#
#...........................................................................................................................#
#...........................................................................................................................#
#...........................................................................................................................#
#...........................................................................................................................#
#...........................................................................................................................#
#...........................................................................................................................#
#...........................................................................................................................#
#.......................................##############......................................................................#
#...........................................................................................................................#
#...........................................................................................................................#
#..........................................................######...........................................................#
#...........................................................................................................................#
#......................................................................############.........................................#
#...........................................................................................................................#
#...........................................................................................................................#
#..............................................................................................#################............#
#...........................................................................................................................#
#........................................................................................######.............................#
#....................................................................##################.....................................#
#.........#######...........................................................................................................#
#................................................###########................................................................#
#...........................................................................................................................#
#..............................############.................................................................................#
#...........................................................................................................................#
#############################################################################################################################