.#############################################################################################################################
.#...........................................................................................................................#
.#...........................................................................................................................#
.#...........................................................................................................................#
.#...........................................................................................................................#
.#...........................................................................................................................#
.#...........................................................................................................................#
.#...........................................................................................................................#
.#...........................................................................................................................#
.#...........................................................................................................................#
.#...........................................................................................................................#
.#...........................................................................................................................#
.#...........................................................................................................................#
.#...........................................................................................................................#
.#...........................................................................................................................#
.#...........................................................................................................................#
.#...........................................................................................................................#
.#...........................................................................................................................#
.#.......................................##############......................................................................#
.#...........................................................................................................................#
.#...........................................................................................................................#
.#..........................................................######...........................................................#
.#...........................................................................................................................#
.#......................................................................############.........................................#
.#...........................................................................................................................#
.#...........................................................................................................................#
.#..............................................................................................#################............#
.#...........................................................................................................................#
.#........................................................................................######.............................#
.#....................................................................##################.....................................#
.#.........#######...........................................................................................................#
.#................................................###########................................................................#
.#...........................................................................................................................#
.#..............................############.................................................................................#
.#...........................................................................................................................#
.#############################################################################################################################