#############################################################################################################################
#...........................................................................................................................#
#...........................................................................................................................#
#...........................................................................................................................#
#...........................................................................................................................#
#...........................................................................................................................#
#...........................................................................................................................#
#...........................................................................................................................#
#...........................................................................................................................#
#...........................................................................................................................#
#...........................................................................................................................#
#...........................................................................................................................#
#...........................................................................................................................#
#...........................................................................................................................#
#...........................................................................................................................#
#...........................................................................................................................#
#...........................................................................................................................#
#...........................................................................................................................#
#...........................................................................................................................#
#...........................................................................................................................#
#...........................................................................................................................#
#...........................................................................................................................#
#...........................................................................................................................#
#...........................................................................................................................#
#...........................................................................................................................#
#...........................................................................................................................#
#..........#######..........................................................................................................#
#...........................................................................................................................#
#..............................############.................................................................................#
#...........................................................................................................................#
#############################################################################################################################